1111111111111111
1000000000000001
1000010000010001
1000010000111111
1000111101000001
1000000100100001
1001100000000001
1111000000001101
1000000000001111
1001100001111111
1001100000000001
1111111111111111